1100111111
1111111111
1111111111
1111001111
1100001111
1100000011
1100000011
1100000011
1110001111
1111111111
